Hello, hi!: toki!; toki a!
Welcome: kama pona
How are you?: sina pilin seme?
What's your name?: nimi sina li seme?
Good morning: tenpo suno pona
Good afternoon: tenpo suno pona
Good evening: pimeja pona
Good night: lape pona
Goodbye (person leaving): mi tawa
Goodbye (person staying): tawa pona
Good luck: o pona
Have a good day: tenpo suno ni o pona tawa sina
I don't understand: mi sona ala
I don't know: mi sona ala
Do you speak Toki Pona?: sina toki ala toki e toki pona?
Excuse me: o weka e ike mi
Sorry: mi pakala
Please: mi wile
Thank you: pona
You're welcome: pona
I love you: mi olin e sina; sina li pona tawa mi
Help!: o pana e pona tawa mi!; o pona e mi!
Hahaha!: a a a!
All is well, don't worry: ale li pona; ali li pona
Bon appetit: moku pona
What's new?: seme li sin?
Friend: jan pona
Computer: ilo nanpa
Phone: ilo toki; ilo nanpa lili
Where is the library?: tomo pi lipu sona li lon seme?; tomo pi lipu li lon seme?
Bathroom: tomo telo
Can you repeat that?: o toki e ni sin
Year: sike; sike suno; tenpo sike
Day: tenpo suno
Night: tenpo mun
Month: mun; tenpo mun; tenpo mun
School: tomo sona
Penguin: waso pi telo lete
Are you okay?: sina li pona ala pona?
Pet: soweli suwi; soweli tomo
Where are you from: sina tan ma seme?
I'm from ...: mi tan ma ...; mi kama tan ma ...
Do you understand?: sina sona ala sona?