a: (interjection) ah, oh, ha, eh, um, oy; (particle) [placed after something for emphasis or emotion]: pu
akesi: reptile, amphibian, scaly creature, crawling creature: pu
ala: not, nothing, no; (particle) [negates a word or phrase]; (particle) [forms a yes-no question]; (number) zero: pu
alasa: hunt, forage, search, attempt; (preverb) try to: pu
ale: all, every, everything, entirety, universe; (number) one hundred: pu
anpa: bottom, underside; below, beneath; defeated, humble, lowly: pu
ante: different, altered; modify, change; other; difference: pu
anu: (particle) [separates multiple possibilities, replacing another particle], or: pu
awen: stay, remain, wait, pause; protect, keep safe; continue; (preverb) continue to: pu
e: (particle) [marks the start of a direct object]: pu
en: (particle) [separates multiple subjects]: pu
esun: trade, barter, exchange, swap, buy, sell; market, shop, fair, bazaar, place of business: pu
ijo: thing, object, entity, being, matter, phenomenon: pu
ike: negative quality, e.g. bad, unpleasant, harmful, unneeded: pu
ilo: tool, implement, machine, device: pu
insa: inside, center, between, middle, midpoint, internal: pu
jaki: disgusting, unclean, unsanitary, toxic, repulsive, rotten: pu
jan: human being, person, somebody: pu
jelo: yellow, amber, golden, lime yellow, yellowish orange: pu
jo: hold, carry, possess, contain, own: pu
kala: fish, marine animal, sea creature, swimming creature: pu
kalama: to produce sound; sound, e.g. sing, thunder, drum, clap, laugh, beep: pu
kama: arriving, coming, future, summoned; (preverb) to become, manage to, succeed in: pu
kasi: plant, vegetation; herb, leaf: pu
ken: can, may, ability, permission; possibility, maybe; allow, enable; (preverb) to be able to: pu
kepeken: (preposition) using, by means of: pu
kili: fruit, vegetable, mushroom: pu
kiwen: hard object e.g. metal, stone, wood: pu
ko: semi-solid, e.g. paste, powder, goo, sand, soil, clay; squishy, moldable; sticky: pu
kon: air, breath, wind; essence, spirit, soul, ghost; unseen agent: pu
kule: color, pigment; category, genre, flavor; colorful, diverse: pu
kulupu: group, community, society, company, nation, collection, team, crowd: pu
kute: ear, hearing organ; hear, listen, pay attention to, obey: pu
la: (particle) [mark the previous statement as context to the following statement]: pu
lape: sleep, rest, break from an activity or work: pu
laso: turquoise, blue, green, cyan, indigo, lime green: pu
lawa: head, mind, brain; control, lead, guide; government, leader; rule, law: pu
len: cloth, clothing, fabric, textile; covered, hidden, secret, private: pu
lete: cold, cool, frozen; freeze, chill; raw, uncooked: pu
li: (particle) [marks the start of an indicative verb (statement)]: pu
lili: small, short, young; few; piece, part: pu
linja: long, flexible thing, e.g. rope, yarn, hair, fur, line, strand: pu
lipu: flat and bendable object, e.g. paper, card, leaf; written text or document, e.g. book, website, clay tablet: pu
loje: red, magenta, scarlet, pink, rust-colored, reddish orange: pu
lon: present, existing, real, true; (preposition) located at, in, during, in the context of: pu
luka: hand, arm, tactile limb, grasping limb; to grasp, interact with, feel using touch; (number) five: pu
lukin: see, look, view, examine, read, watch; visual; eye, seeing organ; (preverb) try to: pu
lupa: hole, pit, cave, doorway, window, portal: pu
ma: earth, land, soil; country, territory, world; outdoors: pu
mama: parent, ancestor; creator, originator; caretaker, sustainer, guardian: pu
mani: money, currency; thing of value e.g. gold, investment, livestock: pu
mi: (pronoun) I, me, we, us: pu
moku: eat, drink, consume, swallow, ingest; food, edible thing: pu
moli: death, dead, die, dying; kill, murder: pu
monsi: back, behind, rear: pu
mu: (animal noise or communication, onomatopoeia): pu
mun: moon, night sky object, star, celestial body: pu
musi: fun, game, entertainment, art, play, amusing, interesting, comical, silly: pu
mute: many, several, very; quantity; (number) twenty: pu
nanpa: number; (particle) [ordinal number], -th: pu
nasa: strange, unusual, silly, abnormal, unexpected; drunk, intoxicated: pu
nasin: method, doctrine, tradition; path, road, way: pu
nena: protuberances e.g. bump, button, hill, nose: pu
ni: this, that, these, those: pu
nimi: word, name: pu
noka: foot, leg, organ of locomotion, roots: pu
o: (particle) [marks the end of a vocative (who is being spoken to)], [marks the start of an imperative (command, wish, instruction)], should: pu
olin: to have a strong emotional bond with, e.g. affection, appreciation, compassion, respect; platonic, romantic, or familial relationships: pu
ona: (third-person pronoun) he, she, it, they: pu
open: begin, start, open, turn on; beginning: pu
pakala: damaged, broken, botched, harmed, messed up; mistake: pu
pali: work, activity; create, build, design; put effort toward, take action on: pu
palisa: long and hard thing e.g. branch, pole, rod, stick, spine, mast: pu
pan: grains, starchy foods, baked goods e.g. rice, sorghum, bread, noodles, masa, porridge, injera: pu
pana: give, send, emit, provide, put, release: pu
pi: (particle) [group the following words into one modifier for the previous word]: pu
pilin: experience e.g. emotion, feeling, touch; heart (physical or emotional): pu
pimeja: dark, unlit; dark color, e.g. black, purple, brown: pu
pini: finish, stop, prevent; close, disable, turn off; ended, past; edge, end, conclusion: pu
pipi: insect, bug, spider, tiny crawling creature: pu
poka: hip, side; next to, nearby, vicinity: pu
poki: container e.g. bag, bowl, box, cup, cupboard, drawer, folder: pu
pona: positive quality, e.g. good, pleasant, helpful, friendly, useful, peaceful: pu
pu: interacting with the book Toki Pona: The Language of Good by Sonja Lang: pu
sama: same, similar, alike; (adjective) peer, fellow, each other; (preposition) similar to, same as: pu
seli: hot, warm; heat, fire, flame; burn: pu
selo: outer layer, e.g. skin, peel, shell, bark; outer shape, outer form, boundary: pu
seme: (particle) [indicate a question by marking missing info in a sentence]; what, which, who: pu
sewi: up, top, above, highest part; divine, sacred, supernatural; awesome, inspiring, excelling: pu
sijelo: body, shape, physical state, torso, substance, form: pu
sike: circle, sphere, spiral, round thing e.g. ball, wheel; repeating thing e.g. cycle, orbit, loop: pu
sin: new, fresh, update; repeat, do again: pu
sina: (pronoun) you, y'all: pu
sinpin: vertical surface e.g. wall, board; front of something e.g. face: pu
sitelen: mage, picture, representation, symbol, mark, writing: pu
sona: knowledge, information, data; know, be skilled in, be wise about; (preverb) know how to: pu
soweli: fuzzy creature, land animal, beast: pu
suli: big, heavy, large, long, tall, wide; important, relevant: pu
suno: light, shine, glow, radiance; sun, light source; brightness: pu
supa: flat horizontal surface, especially to put or rest things on e.g. bed, floor, desk, plate, table, platform, stage: pu
suwi: sweet, fragrant; cute, adorable: pu
tan: (preposition) from, because of; cause, origin: pu
taso: only, exclusively; (particle) [marks a sentence as qualifying or contradictory], but, however: pu
tawa: motion, e.g. walking, shaking, flight, travel; (preposition) to, for, going to, from the perspective of: pu
telo: liquids e.g. water, gasoline, soda, lava, soup, oil, ink: pu
tenpo: time, event, situation, moment, period, duration: pu
toki: communicate, say, think; conversation, story; language: pu
tomo: indoor space or shelter e.g. room, building, home, tent, shack: pu
tu: (number) two; separate, divide, split: pu
uta: mouth, lips, throat, consuming orifice: pu
utala: fight, compete, battle; competition, challenge; struggle, strive: pu
walo: light-colored, white, pale, light gray, cream: pu
wan: (number) one; singular; combine, join, mix, fuse: pu
waso: bird, flying creature, winged animal: pu
wawa: power, energy, strength; confident, intense, forceful; amazing, impressive: pu
weka: absent, away, distant; remove, get rid of: pu
wile: want, desire, wish, require; (preverb) want to: pu
kijetesantakalu: raccoon, kinkajou; any procyonid; any musteloid: ku
kin: (particle) [after phrase or at sentence start] too, also, as well, additionally: ku
kipisi: split, cut, slice; piece, part; sharp, pointy: ku
ku: interacting with the book Toki Pona Dictionary (2021) by Sonja Lang: ku
leko: square, cube, block, blocky object e.g. bricks, stairs: ku
meli: woman, female, wife, girlfriend: pu
mije: man, male, husband, boyfriend: pu
misikeke: medical item or practice e.g. prescriptions, meditation, exercise, bandages, therapy: ku
monsuta: fear, nervousness, dread; scary, frightening; scary thing e.g. predator, threat, danger: ku
n: (interjection) hm, uh, mm, er, umm, [indicate thinking or pause]: ku
namako: spice, ornament, adornment; extra, additional: ku
soko: mushroom, fungus, lichen: ku
tonsi: nonbinary, gender nonconforming, genderqueer, transgender: ku
ali: [pronunciation variant of ale]: pu
epiku: epic, cool, awesome, amazing: ku
jasima: reflect, echo; mirror, duplicate: ku
lanpan: take, seize, steal: ku
linluwi: bonded things which are stronger through their bonds e.g. network, internet, connection; weave, braid, interlace: ku
majuna: old, aged, ancient: ku
meso: midpoint, medium, mediocre; neither one not the other, neither fully is nor isn't: ku
nimisin: any non-pu word; any new word; any joke word: community
oko: see, look, view, examine, read, watch; visual; eye, seeing organ; (preverb) try to: ku
su: interacting with a book from the illustrated story book series that began with The Wonderful Wizard of Oz, produced by Sonja Lang: ku
